#	CLASS
MAX17048	KEYWORD1		DATA_TYPE
Gauge	KEYWORD1		DATA_TYPE

#	METHODS
open	KEYWORD2
reset	KEYWORD2
quickStart	KEYWORD2
sleepEnabled	KEYWORD2
hibernating	KEYWORD2
hibernateThreshold	KEYWORD2
activeThreshold	KEYWORD2
version	KEYWORD2
compensation	KEYWORD2
tempCompensation	KEYWORD2
sleeping	KEYWORD2
sleep	KEYWORD2
socChangeAlertEnabled	KEYWORD2
alerting	KEYWORD2
clearAlert	KEYWORD2
emptyAlertThreshold	KEYWORD2
vAlertMinThreshold	KEYWORD2
vAlertMaxThreshold	KEYWORD2
vResetThreshold	KEYWORD2
comparatorEnabled	KEYWORD2
id	KEYWORD2
vResetAlertEnabled	KEYWORD2
alertFlags	KEYWORD2
clearAlertFlags	KEYWORD2
vcell	KEYWORD2
soc	KEYWORD2
soc_int	KEYWORD2
crate	KEYWORD2

RCOMP0	LITERAL2		RESERVED_WORD_2

AlertFlags	LITERAL2		RESERVED_WORD_2
ALERT_RI	LITERAL2		RESERVED_WORD_2
ALERT_VH	LITERAL2		RESERVED_WORD_2
ALERT_VL	LITERAL2		RESERVED_WORD_2
ALERT_VR	LITERAL2		RESERVED_WORD_2
ALERT_HD	LITERAL2		RESERVED_WORD_2
ALERT_SC	LITERAL2		RESERVED_WORD_2